[ID]
[通用][必须]名=name
[通用][必须]说明=notes
[通用][必须]图标=icon
[必须]技能效果=effect
[必须]效果位置=position
[必须]法术标识=distinguish
[必须]技能最大等级=grade_max
[必须]技能施法需求魔法=Demand_Magic
[必须]技能施法每级增加需求魔法=Demand_Magic_increase
[必须]持续回合数(0回合为被动技能)=last

技能增加生命=life
技能增加魔法=Magic
技能增加生命恢复=restored_life
技能增加魔法恢复=restored_Magic
技能增加物理攻击=Physics_Attack
技能增加魔法攻击=Magic_Attack
技能增加物理闪避=Physics_ducked
技能增加魔法闪避=Magic_ducked
技能增加物理命中=Physics_Hit
技能增加魔法命中=Magic_Hit
技能增加速度=Speed

技能每级增加生命=life_increase
技能每级增加魔法=Magic_increase
技能每级增加生命恢复=restored_life_increase
技能每级增加魔法恢复=restored_Magic_increase
技能每级增加物理攻击=Physics_Attack_increase
技能每级增加魔法攻击=Magic_Attack_increase
技能每级增加物理闪避=Physics_ducked_increase
技能每级增加魔法闪避=Magic_ducked_increase
技能每级增加物理命中=Physics_Hit_increase
技能每级增加魔法命中=Magic_Hit_increase
技能每级增加速度=Speed_increase